distancia	fijada
interés	suscitado
conmoción	causado
atención	llamar
hijos	tiene
peligro	supone
olor	desprende
ejemplo	Es
peligro	pone
corrientes	crear
viaje	enviaron
historia	construir
ronda	iniciar
nexo	establece
debate	inicie
representación	Asistimos
templo	levantaron
negocio	lanzar
atención	atraer
incremento	supone
proyecto	aprobación
bomba	fabricar
Gobierno	formó
consecuencia	fue
calma	traer
gobierno	establecer
castigo	es
escándalo	provocó
hoguera	enciendan
Constitución	elabore
sociedad	creará
radiaciones	producidas
paredes	levantó
huevos	poner
dinero	ganaban
reunión	acudió
ondas	generar
empleo	creado
grupos	creados
celos	provocados
situación	abre
rayos	disparados
rayos	emitidos
amigos	tengo
acontecimientos	acudir
epidemia	causar
ventaja	supone
rastro	dejar
crecimiento	supone
cánones	establecidos
halago	fuera
pañito	haciendo
peligro	pondremos
golpe	sufrido
hotel	construido
riqueza	generando
anticuerpos	segregados
empleo	creando
modelos	produjo
proceso	iniciar
interés	despertado
onda	generando
maniobra	urdida
arreglo	tiene
derecho	garantiza
oficina	abrió
síntomas	produce
amiga	Tengo
presentación	asistido
pena	da
beneficio	causa
cirrosis	provoca
retroceso	supone
debate	generado
elecciones	presenten
señal	emite
democracia	construcción
avance	supone
gusto	dé
elecciones	convocar
vacunas	fabricar
entusiasmo	causa
consecuencias	acarrear
edificio	construido
grupo	creas
ruina	llevar
medios	poner
contratos	creación
ola	provocó
sistema	instaurar
editorial	fundó
operación	someterse
interés	despertará
ordenes	emitió
hijo	tener
ilusión	producen
atención	llamó
colecta	abierto
crisis	originó
riqueza	generan
empleo	crear
respeto	suscitado
concierto	ido
pasiones	levanta
beneficios	producen
taberna	abrió
controversia	suscita
bares	abren
proyecto	aprobar
ilusión	hace
peligro	poner
llamas	provocar
mercado	insertar
aludes	provocar
ondas	generadas
modelo	sirvió
acto	presenciar
objetivos	marcados
primas	fabricación
miedo	causa
enfermedades	provoca
cena	organizada
bombas	fabricar
entorno	creando
pavor	producían
reflexión	mueven
simpatía	despertaba
compañía	creada
problema	supuesto
programa	establecido
vacunas	fabrican
hija	tiene