tarea	desempeñó
indicios	tenemos
desafíos	presentan
huelga	estaban
participación	tienen
premios	entregó
prácticas	realizaría
debate	celebró
peligro	corre
estética	tiene
elecciones	participar
certificados	emitir
degeneración	sufre
desprestigio	sufrido
mentalidad	tiene
intuición	desarrollado
funerales	oficiados
experiencias	llevaron
ejercicio	hizo
elecciones	celebrarán
nombre	lleva
medidas	adoptadas
tolerancia	gozó
críticas	pronunció
capacidad	tenemos
reunión	celebrará
tirrias	tenemos
bien	hacer
ganas	tener
derecho	tiene
ruido	hace
contratos	registrado
reunión	celebraban
manía	tienen
preguntas	hacer
valor	tenido
gimnasia	hacía
años	tenía
evidencia	poner
conciencia	tenían
presión	ejercer
beso	dar
mandato	ejerza
comezón	sentía
propuesta	presentado
apariencia	ofreció
exhibición	realizó
lágrima	derramar
salto	diera
experimentos	realizaron
importancia	tuvieron
centavo	tengo
retroceso	sufrido
demanda	presentado
faltas	hacen
toques	dan
programas	desarrollándo
años	tiene
espanto	sufrido
justificación	tendrán
patadón	propinan
promesas	realizó
elecciones	celebradas
tertulias	participan
beneficios	otorga
conocimiento	tuvo
crecimiento	registra
amistad	tiene
pánico	sentir
esfuerzo	vertiendo
berrido	sueltan
cola	hacen
éxito	obtuvo
transfusiones	realizar
contratos	realizaron
día	pasó
éxitos	obtuvo
color	tiene
tentación	siente
toque	dio
privilegio	tuvieron
sensación	tenía
margen	tenía
nota	tomó
misivas	remitidas
novillos	haciendo
efectos	tuvo
secuestros	realizado
aire	tiene
espacio	ocupaba
capacidad	tener
virguerías	hecho
grupo	pertenecen
día	pasan
mando	recados
sanciones	imponer
cortesía	guardando
pérdidas	sufren
guerra	practicando
temas	tratarán
pruebas	realizadas
decisión	tomara
vuelta	celebrada
problemas	sufría
juergas	correrse
lujos	Tenías
final	tenido
fortuna	tenido
elecciones	hagan
presencia	falta
puestos	ocupado
resolución	emitió
adiós	dicho
crochet	haciendo
esfuerzo	dedicado
propuestas	presentaron
bombas	lanzar
miedo	sentir
presencia	tiene
congreso	celebran
goles	meter
importancia	tiene
hincapié	hacer
retos	fijados
medidas	adoptar
fiesta	dio
corazón	tenemos
goles	metido
tentación	tienen
guerra	hacen
grandeza	carece
recorrido	efectuará
carreras	cursan
dinero	tiene
caridad	hacer
sanción	impuesta
empujón	dar
calceta	hacer
sanciones	impongan
piropos	lanza
caso	haz
marca	llevan
derecho	tenga
salario	pagaban
faltas	cometer
experiencias	realizado
medidas	realizaron
cuya	celebración
carisma	tuvo
faltas	practican
conjeturas	lanzado
miedo	tenemos
bocanadas	echando
reglas	establecidas
peligro	corren
dudas	tiene
la	tenemos
ganas	Tengo
velocidad	tiene
marcha	participaron
problemas	tiene
acuerdos	lleguen
siesta	echarme
derroches	hacer
Presidencia	ocupa
giro	experimentó
gala	hizo
cargos	ocupaba
analogía	hacemos
fama	llevan
lugar	ocupar
betún	dar
manía	tenía
convicción	tenía
ejemplo	ponía
licencias	tienen
historia	tienen
declaraciones	realizadas
modificaciones	realice
bienvenida	dar
crisis	enfrenta
visos	poseen
conocimiento	tuvieron
cabida	tienen
mofa	hiciera
comunicaciones	realizadas
sacrificio	hacer
suerte	echada
influencia	ejerce
tertulias	participar
presidencia	ocuparán
dificultades	presentan
poder	tienen
ejercicio	Hacer
oportunidad	tener
opiniones	dar
facultad	tienen
influencia	tuvo
certeza	tuvo
reafirmación	hará
estrategia	desarrolló
significado	tenían
casta	Tiene
aprecio	tiene
chantaje	realizan
derecho	tenía
cizaña	meter
concepto	tiene
luto	iban
Cumbre	celebrará
noticia	tenía
caída	soporta
motivos	tiene
reuniones	celebrará
aire	tenían
sede	tiene
medidas	adoptaron
búsqueda	efectuar
telele	sufrieran
regla	tienen
embolia	sufrido
miga	tenían
idea	tendrán
proeza	logrado
cambios	comportando
tendencia	Tienen
rito	celebrar
paperas	padecen
test	realizado
rumores	lanzar
labor	desarrolla
imágenes	tomadas
mirada	echar
oportunidades	tenido
partido	hizo
invocaciones	hacen
puestos	cubrir
referencia	tuvo
aversión	sienta
accidente	sufrido
espantadas	producían
llamadas	hecha
uso	hizo
potencial	posee
goles	marcar
ofertas	hecho
justificación	tenía
alteración	sufrido
respuesta	dar
Asamblea	celebrará
cargo	ocupen
los	celebrar
oportunidades	tuvieran
vergüenza	tuvo
derrame	sufrió
retos	propongan
aumento	experimentado
diferencias	presentan
exaltación	efectuado
información	facilitado
encuentro	celebran
intención	tiene
suerte	Tuvieron
vuelta	dar
gripe	sufrirse
mutaciones	sufrir
decisión	tome
uso	Haciendo
manifiesto	pone
alza	experimentó
idea	tiene
derecho	tengo
viaje	hagan
pasos	dar
crisis	atraviesa
fuerzas	tuvo
faltas	provocan
lindezas	haciendo
comentario	hacía
aumento	registraron
palmadas	dándo
oxidación	producida
decisión	adoptará
disposición	tiene
adaptaciones	hacer
tiempo	tenía
señales	dar
sentido	tiene
infección	provocada
pauta	marcará
follón	armar
frutos	da
reunión	participar
vida	llevar
triunfo	obtuvo
miedo	tienen
reunión	celebrada
rato	pasar
espacio	ocupó
mensaje	lanzar
venganzas	tomen
misivas	enviadas
calma	tener
reducción	tuvo
mordisco	das
frío	tenían
nexos	tener
frenos	pusiera
ejercicios	haciendo
huella	grabada
esperanza	cabe
remedio	tenía
servicios	darán
fama	goza
gestiones	realizadas
putadas	haciendo
pleitos	tenía
búsqueda	desarrolló
catarro	sufrirá
conclusiones	extrajo
atención	presta
decisión	tomada
ejercicio	practican
faltas	cometen
origen	tuvieron
faltas	hacer
lágrimas	derramó
vueltas	dar
premio	dieron
campaña	hacer
faltas	hagamos
liberalización	hecho
negociaciones	desarrollado
conferencia	pronunciada
regalos	hacer
matrimonio	contraer
métodos	utilizar
razón	tiene
cartas	enviadas