emociones	mostrar
listas	engrosen
número	aumenta
multa	reducida
radicalidad	Aumentar
paro	bajó
conductividad	disminuye
disconformidad	expresar
periodo	ampliar
pérdidas	mitiga
plantilla	reducido
capacidad	disminuiría
medidas	minimizar
fondos	rebajar
protagonismo	robado
precios	subir
importancia	reducir
costes	aliviar
nostalgia	expresa
coste	aumenta
Confusión	acrecentada
economía	reavivar
temperatura	disminuye
recuerdo	ALIMENTADO
inteligencia	estimula
mercado	incentivar
precipitaciones	reduciendo
esfuerzo	aumente
seguridad	manifestó
colaboración	incentivar
presión	elevar
tiempo	disminuyendo
protagonismo	restado
hierba	crecía
fuerzas	exhibió
exportaciones	aumentaron
cultura	elevar
monto	reduce
solemnidad	quita
temporalidad	reducir
necesidad	urgió
tendencia	reforzó
poder	robustecer
paro	aumentó
población	crezca
cifra	aumentó
déficit	subió
generoso	muestra
disposición	mostró
desempleo	disminuido
competencia	incentiven
siniestralidad	frenar
prudencia	cultivar
intenciones	anunciando
apoyo	manifestado
número	reducido
control	fortalecer
interacción	incrementa
divisas	subieron
paro	bajara
altivo	mostraba
gasto	bajar
interrelación	fortalecerá
inflación	reducir
inversiones	incentivar
número	creció
plazo	ampliará
evolución	frena
popularidad	caído
paro	disminuye
mejorías	muestra
espesor	aumentará
señales	muestra
liderazgo	refuerza
sospechas	aumentar
paro	subió
valor	aumentaba
temporalidad	crecido
tasa	rebajar
conductividad	aumenta
precios	elevado
conductividad	eleva
indiferencia	alimentado
temporalidad	reducir
piedad	mostrar
número	reducirá
Bolsa	cae
dinero	reducido
exportaciones	redujeron
paro	descendido
exigencias	aumentar
capacidades	mermen
número	subió
preocupación	mostró
grieta	ampliarse
previsiones	reduciría
déficit	reducir
paro	descendió
deseos	incrementan
dotaciones	aumentar