suerte	mala
fatal	caso
situación	desfavorable
gusto	mal
sheriff	corrupto
olor	insoportable
consecuencias	devastadoras
gestionado	mal
lleven	mal
estructuras	deficientes
bromas	pesadas
realidad	terrible
idea	truculenta
momento	duro
obligaciones	dura
datos	desfavorables
sarcasmo	cruel
hombre	abominable
efectos	terribles
hierba	mala
conciencia	malsana
plagas	terribles
ambiente	deprimente
contratos	basura
casos	lamentables
saldo	fatal
barba	desaliñada
hecho	desgraciado
temporada	dura
turba	infametumores	malignos
consecuencias	catastróficas
estado	patético
incidentes	lamentables
estado	desastroso
película	terrible
efectos	temibles
situación	grave
sueños	malos
coartadas	fatídicas
fracasos	amargos
trampa	burda
situación	trágica
hechos	desgraciados
fario	mal
lucha	terrible
tendencia	grave
accidente	atroz
realidad	horrible
dudas	temibles
afición	reprobable
efectos	negativos
degeneración	terrible
situación	precaria
condiciones	adversas
racha	mala
