suerte	mala
tamaño	pequeño
situación	desfavorable
gusto	mal
sheriff	corrupto
olor	insoportable
fuerza	ligera
valores	bajos
lleven	mal
salario	bajo
discurso	breve
realidad	terrible
idea	truculenta
momento	duro
obligaciones	dura
huella	débil
sarcasmo	cruel
hombre	abominable
plazo	corto
hierba	mala
estabilidad	baja
plagas	terribles
caos	insignificante
golpe	leve
disquisiciones	breves
saldo	fatal
cristalinidad	baja
hecho	desgraciado
temporada	dura
turba	infametumores	malignos
frecuencias	bajas
respuestas	concretas
incidentes	lamentables
resistencia	escasa
película	terrible
muralla	frágil
situación	grave
sueños	malos
esperanzas	mínimas
temporada	corta
trampa	burda
situación	trágica
hechos	desgraciados
solubilidad	baja
lucha	terrible
tendencia	grave
cable	fino
realidad	horrible
lapso	corto
cantidades	insignificantes
luz	débil
indiferencia	sutil
situación	precaria
estabilidad	escasa
racha	mala
