oposición	eficaz
costumbres	buenas
personas	admirables
reputación	buena
equipo	gran
experimentos	fascinantes
carrera	brillante
palabra	hermosa
posición	mejor
estrategia	eficaz
relación	armoniosa
camino	buen
predisposición	favorable
apellidos	ilustres
honradez	sana
investigación	fecunda
cuidado	bien
inversión	atractiva
forma	buena
aspectos	positivos
resultados	buenos
elección	limpia
defensa	eficaz
quedan	bien
ejercicio	impecable
lleven	bien
condiciones	buenas
ejemplo	mejor
acción	eficaz
cuidados	bien
habla	perfectamente
atención	eficaz
proceder	recto
aspecto	cuidado
va	mejor
funcionó	bien
tiempos	mejores
manera	excelente
árboles	frondososllevo	bien
intención	noble
lectura	mejor
pruebas	prometedoras
investigación	calidad
nota	buena
momento	propicio
van	bien
test	preciso
hombre	bueno
medidas	eficaces
juega	bien
salga	bien
mayores	ilustres
experiencia	valiosísima
trabajo	buen
modelo	buen
niña	buena
resultado	inmejorable
gestión	espléndida
entrada	triunfal
acaban	bien
llevaba	mejor
días	buenos
acciones	espléndidas
efectos	extraordinarios
tiempo	buen
proporciones	justas
tiempos	buenos
sol	espléndido
día	hermoso
momento	adecuado
preguntas	certeras
condiciones	favorables
viaje	feliz
lleva	bien
