línea	trazada
régimen	impuesto
derecho	garantiza
fuego	prende
ondas	generadas
compañía	creada
escándalo	provocó
templo	levantaron
calma	traer
organismos	crear
caminos	abren
grupos	creados
riqueza	generan
distinción	establezcan
sociedad	creará
bares	abren
ola	provocó
oficinas	abierto
empleo	crear
competencia	restablecer
historia	construir
empleo	creando
bomba	fabricar
templo	levantar
distancia	fijada
corrientes	crear
rastro	dejar
democracia	construcción
nexo	establece
cirrosis	provoca
debate	inicie
aludes	provocar
contratos	creación
entorno	creando
bombas	fabricar
proyecto	aprobación
beneficios	producen
oficina	abrió
empresas	fundar
señal	emite
maniobra	urdida
venenos	generarllamas	provocar
gobierno	establecer
hoguera	enciendan
olor	desprende
grupo	creas
onda	generando
negocio	lanzar
vacunas	fabrican
proyecto	aprobar
fuego	hacer
medidas	aprobado
heridos	produjo
vacunas	fabricar
medidas	aprobadas
primas	fabricación
elecciones	convoque
taberna	abrió
medios	poner
objetivos	marcados
reflexión	mueven
enfermedades	provoca
edificio	construido
Gobierno	formó
huevos	poner
crisis	provocaron
adivinanza	proponiendo
debate	generado
ronda	iniciar
sistema	instaurar
pañito	haciendo
riqueza	generando
rayos	disparados
crisis	originó
modelos	produjo
ordenes	emitió
colecta	abierto
situación	abre
hotel	construido
