voz	acallar
vacío	suplir
gobierno	disolviese
Constitución	derogar
cadenas	rotas
líder	derrocando
casas	arrasadas
igualdad	desajustar
gobierno	derribar
vacante	cubrir
actividad	paralice
actividad	paralizar
vajilla	romper
agravios	dirimir
silencio	cortó
violencia	detener
precariedad	frenar
árboles	arrancarromanticismo	matado
diferencias	derribaban
fuego	apaga
irregularidades	corregir
problema	resolver
comicios	suspender
