reducción	tuvo
betún	dar
corazón	tenemos
paperas	padecen
problemas	tiene
infección	provocada
debate	participaron
tolerancia	gozó
puestos	ocupado
accidentes	sufrieron
capacidad	tener
esfuerzo	dedicado
espacio	ocupaba
venganzas	tomen
salario	pagaban
amenazas	esgrime
tiempo	tenido
ejemplo	ponía
prácticas	realizaría
Presidencia	ocupa
analogía	hacemos
elecciones	participar
centavo	tengo
historia	tienen
rato	pasar
chantaje	realizan
motivos	tiene
grupo	pertenecen
gripe	sufrirse
mutaciones	sufrir
hincapié	hace
diferencias	presentan
años	tenía
acuerdos	lleguen
medidas	realizaron
medidas	adoptadas
derecho	tiene
declaraciones	realizadas
presencia	tiene
berrido	sueltan
guerra	practicando
toque	dio
dinero	tiene
nota	tomó
desventajas	tenía
presidencia	ejerce
elecciones	hagan
experiencias	llevaron
estética	tiene
siesta	echarme
uso	hizo
noticia	tenía
valor	tenido
tentación	siente
derrame	sufrió
frenos	pusiera
sede	tiene
vida	llevar
oportunidades	tenido
convicción	tenía
final	tenido
sanciones	imponer
conferencia	pronunciada
inconvenientes	reporte
disposición	tiene
pauta	marcará
funerales	oficiados
liberalización	hecho
uso	Haciendo
rumores	lanzar
frente	hacer
pruebas	disponer
bombas	lanzar
escasez	tienen
prejuicios	tenían
fin	poner
jornadas	intervino
juergas	correrse
caída	soporta
desdén	sentir
idea	tiene
guerra	hacen
actos	efectúa
resolución	emitió
partido	hizo
experiencias	realizado
estrategia	desarrolló
afecto	sentía
mandato	ejerza
degeneración	sufre
contratos	registrado
lindezas	haciendo
modificaciones	realice
faltas	provocan
trabajo	Hizo
los	celebrar
mando	recados
putadas	haciendo
ganas	tener
crochet	haciendo
reglas	establecidas
faltas	hacen
transfusiones	realizar
espantadas	producían
miedo	tenemos
cuya	celebración
comezón	sentía
potencial	posee
efectos	tuvo
decisión	adoptará
esfuerzos	hecho
suerte	echada
decisión	adopten
uso	hacer
comentario	hacía
aumento	experimentado
búsqueda	desarrolló
espacio	ocupa
día	pasó
la	adoptar
idea	tendrán
gala	hizo
color	tiene
incremento	presenta
mentalidad	tiene
manifiesto	pone
margen	tenía
razón	tiene
invocaciones	hacen
ejercicio	Hacer
espacio	ocupó
propuestas	presentaron
crecimiento	registra
reunión	participar
licencias	tienen
ridículo	hacer
medidas	adoptar
sentido	tiene
proeza	logrado
ganas	Tengo
piropos	lanza
perspectivas	tiene
luto	iban
permiso	dar
elecciones	celebradas
búsqueda	efectuar
aire	tenían
origen	tuvieron
gestiones	realizadas
medidas	emplean
desinfección	realizó
frío	tenían
peligro	corren
pregunta	hace
origen	dé
objetivo	tienen
dificultades	presentan
traspiés	dando
partidos	jugados
velocidad	tiene
poderío	tenía
lujos	Tenías
tendencia	Tienen
reunión	celebrada
faltas	hacer
reunión	celebraban
empujón	dar
exaltación	efectuado
huelga	estaban
hincapié	hacer
visos	poseen
Premio	otorga
lugar	ocupar
detalles	ofreciendo
dudas	tiene
la	tenemos
regalos	hacer
oportunidades	teníamos
ejercicio	practican
retos	propongan
derecho	tenía
presidencia	ocuparán
elección	participar
sonrisa	tienen
capacidad	tenemos
test	realizado
cizaña	meter
cortesía	guardando
marca	llevan
gimnasia	hacía
experimentos	realizaron
aire	tiene
bocanadas	echando
beneficios	otorga
fama	tiene
esfuerzo	vertiendo
reafirmación	hará
palmadas	dándo
justificación	tendrán
decisiones	toman
carreras	cursan
manía	tenía
privilegio	tuvieron
promesas	realizó
frutos	da
calma	tener
puestos	cubrir
impulso	daba
oportunidades	tuvieran
miedo	sentir
retroceso	sufrido
accidente	sufrido
miedo	tienen
suerte	Tuvieron
decisión	tome
labores	realizar
sacrificio	hacer
influencia	tuvo
fiesta	dio
decisión	tomada
pasos	dar
intención	tiene
certeza	tuvo
cargos	ocupaba
bien	hacer
métodos	utilizar
huella	dejó
viaje	hagan
años	tiene
señales	dar
llamadas	hecha
misivas	enviadas
participación	tienen
faltas	cometer
ruido	hace
entrevista	realizada
certificados	emitir
empleos	cubrir
ejercicios	haciendo
adaptaciones	hacer
cita	dan
pleitos	tenía
alteración	sufrido
experiencia	tenían
calceta	hacer
tertulias	participar
sanciones	adoptar
interés	Tienen
oportunidad	tener
sanciones	imponen
lágrimas	derramó
imágenes	tomadas
influencia	ejerce
peligro	corre
tentación	tienen
mensaje	lanzar
violaciones	cometido
tertulias	participan
posibilidades	tienen
nexos	tener
huella	grabada
faltas	cometen
campaña	hacer
intuición	desarrollado
goles	metido
premios	entregó
mirada	echar
derecho	tenga
cartas	envió
Cumbre	celebrará
carisma	tuvo
contratos	realizaron
importancia	tuvieron
bocados	pegar
mofa	hiciera
cumbre	participar
regla	tienen
cartas	enviadas
retos	fijados
mordisco	das
manía	tienen
alcance	tiene
problema	tiene
crisis	enfrenta
novillos	haciendo
faltas	practican
putadas	hacer
vuelta	celebrada
embolia	sufrido
preguntas	hacer
valor	tiene
programas	desarrollándo
marcha	participaron
caso	haría
sanciones	impongan
carreras	celebraban
follón	armar
goles	meter
éxito	obtuvo
giro	experimentó
fama	llevan
caza	dar
caridad	hacer
respuesta	dar
lágrima	derramar
mensajes	transmite
aprecio	tiene
presión	ejercer
facultad	tienen
observaciones	hace
golpes	darán
tiempo	pasó
patadón	propinan
respuesta	da
miedo	tuvo
premio	dieron
estilo	tiene
elecciones	celebrarán
estupideces	cometa
salto	diera
decisión	tomara
significado	tenían
crisis	atraviesa
pánico	sentir
información	facilitado
día	pasan
éxitos	obtuvoaportación	hace
goles	marcar
concepto	tiene
derecho	tengo
nombre	lleva
reuniones	celebrará
defensa	hacer
